#Example: Large parts of Africa and south east Asia
tropical = { 
	# Southwest Africa
}
arid = { 
}
arctic = { 
}
#Example: Most of Europe north of med.
mild_winter = { 
}
#Example: Inland Europe & Scandinavia
normal_winter = { 
	# Scandinavia
	444 1967 1968 889 890 782 2869 2870 2875 2876
	1033 4658 676 705 2128 2134 4204 4514 4515 4516
	4518 4519 4520 427 435 447 739 577 2222 2235
	4210 437 438 441 442 455 2349 2363 2350 885
	891 1808 1786 2216 2224 2229 2230 2232 2496 4206
	4207 780 781 2861 2863 2865 18 21 4113 4114
	4151 4152 313 315 1776 1777 2102 2103 1048 4256
	4257 4258 370 371 1104 1105 458 1034 1035 1036
	1037 1038 1039 1040 1041 1042 1043 1044 1045 1046
	1047 1051 1052 1054 1055 1059 1061 1062 1064 1067
	1068 1069 1070 1071 1072 1073 1074 1075 1076 1077
	1078 1080 2425 1780 2426 2427 2428 2429 2433 2445
	2432 2443 2430 2431 2436 2437 2442 2435 2446 2438
	2439 2440 4691 977 978 979 1809 996 997 998
	999 1004 1005 1006 1009 1781 1782 1783 1785 1804
	1805 1806 1807 1810 1811 1812 1814 1784 1787 1955
	1964 1963 2200 2009 2574 2575 2576 2577 2578 2591
	2592 2593 2594 2611 2612 2613 4205 2025
}
#Example: Russia & Lappland
severe_winter = { 
}

impassable = { 
	3218 3238 3200 3004 3419 3219 2009 2008 2007 3290 3105 3013 3420 3289 3721 3500 3288 3505
}
mild_monsoon = { 
}
normal_monsoon = { 
}
severe_monsoon = { 
}
equator_y_on_province_image = 1
