width = 5632
height = 2304

max_provinces = 4942
sea_starts = { 
	1567 1564 1582 1583 1578 1580 1565 1574 1571 1568 1581 1561 1289 1570 1577 1565 1304 1290
	1976 1888 1327 1263 4941 3525 1696 1695 1697 1694 1665 1664 1663 1741 1740 1683 4135 1291
	1739 1738 1737 1737 1736 1735 1734 1733 1732 1731 1730 1729 1728 1727 1726 1725 1724 1723
	1722 1721 1720 1719 1718 1717 1716 1715 1714 1713 1712 1711 1710 1709 1708 1707 1706 1705
	1703 1704 1690 1691 1692 1693 1697 1698 1699 1700 1701 1702 1687 1689 1688 1687 1686 1685
	1684 1682 1681 1680 1679 1677 1678 1563 1676 4357 1500 1501 1292 1293 4000 4347 4346 1325
	1250 1251 1252 1253 1254 1255 1256 1257 1258 1259 1260 1261 1262 1263 1264 1265 1266 1267
	1268 1269 1270 1271 1272 1274 1275 1276 1277 1278 1279 1280 1281 1282 1283 1284 1285 1647
	1286 1287 1288 1290 1291 1292 1293 1294 1295 1296 1297 1298 1298 1299 1300 1301 1302 1622
	1303 1304 1305 1307 1308 1309 1310 1311 1312 1313 1636 1618 1615 1586 1530 1459 1446
	1423 1336 1326 1616 1531 1532 1533 1534 1535 1536 1537 1538 1539 1540 1541 1542 1543 1544
	1545 1546 1547 1548 1549 1550 1551 1552 1553 1554 1555 1556 1557 1558 1559 1560 1562 1566
	1569 1572 1573 1575 1576 1579 1584 1585 1587 1588 1589 1590 1591 1592 1593 1594 1595 1596
	1597 1598 1599 1600 1601 1602 1603 1604 1605 1606 1607 1608 1609 1610 1611 1612 1613 1614
	1617 1619 1620 1621 1623 1624 1625 1626 1627 1628 1629 1630 1631 1632 1633 1634 1635 1637
	1638 1639 1640 1641 1642 1643 1644 1645 1646 1648 1649 1650 1651 1652 1653 1654 1655 1656
	1657 1658 1659 1660 1666 1667 1668 1669 1670 1671 1672 1673 1674 1675 1684 1696 1314 1315
	1316 1317 1320 1321 1322 1323 1324 1328 1329 1330 1331 1332 1333 1334 1335 1337 1338
	1339 1340 1341 1342 1344 1345 1022 1053 1231 1235 1236 1237 1238 1245 1346 1347 1348 
	1349 1350 1351 1352 1353 1354 1355 1356 1357 1358 1359 1360 1361 1362 1363 1364 1365 1366 
	1367 1368 1369 1370 1371 1372 1373 1374 1375 1376 1377 1378 1379 1380 1381 1382 1383 1384 
	1385 1386 1387 1388 1389 1390 1391 1392 1393 1394 1395 1396 1397 1398 1399 1400 1401 1402 
	1403 1404 1405 1406 1407 1408 1409 1410 1411 1412 1413 1414 1415 1416 1417 1418 1419 1420 
	1421 1422 1424 1425 1426 1427 1428 1429 1430 1431 1432 1433 1434 1435 1436 1437 1438 1439 
	1440 1441 1442 1443 1443 1444 1445 1447 1448 1449 1450 1451 1452 1453 1454 1455 1456 1457 
	1458 1460 1461 1462 1463 1464 1465 1466 1467 1468 1469 1470 1471 1472 1473 1474 1475 1476 
	1477 1478 1479 1480 1481 1482 1483 1484 1485 1486 1487 4656 1489 1490 1491 1492 1493 1494 
	1495 1496 1497 1498 1499 1502 1503 1504 1505 1506 1507 1508 1509 1510 1511 1512 1513 1514 
	1515 1516 1517 1517 1518 1519 1520 1521 1522 1523 1524 1525 1526 1527 1528 1529 1734 1788 
	1789 1867 1886 1887 1890 1891 1892 1893 1894 1895 1896 1897 1898 1899 1900 1902 4650
	1903 1904 1905 1906 1907 1908 1909 1910 1911 1912 1913 1914 1915 1916 1917 1918 1919 1919 
	1920 1921 1922 1923 1924 1926 1927 1928 1929 1932 1950 1975 1977 1980 1990 1991 1992 1993 
	1995 1996 2000 2001 2003 2004 2005 2006 2070 2071 2081 2091 2096 2098 2107 2109 2110 2111 
	2112 2113 2114 2115 2116 2117 2123 2130 2131 2132 2133 2134 2135 2136 2138 2139 2140 2141 
	2142 2143 2144 2145 2146 2147 2148 2149 2150 2151 2152 2153 2156 2157 2158 2159 2160 2161 
	2162 2163 2164 2165 2166 2167 2168 2169 2170 2171 2172 2173 2174 2175 2176 2177 2178 2179 
	2180 2181 2182 2183 2184 4667 2186 2187 2188 4665 2190 2191 4664 2193 2194 2229 2342 2371 
	2372 2373 2374 2375 2376 2377 2378 2379 2380 2381 2382 2383 2384 2385 2386 2387 2388 2389 
	2390 2391 2392 2393 2394 2395 2396 2397 2398 2399 2400 2401 2402 2403 2404 2446 2471 2616 
	2620 2625 2639 2665 2666 2740 2747 2749 2953 3009 3010 3011 3012 3014 3015 3018 3020 3021 
	3022 3023 3024 3025 3026 3027 3028 3029 3030 3031 3032 3033 3034 3035 3036 3038 3039 3040 
	3041 3043 3044 3045 3046 3047 3048 3050 3051 3053 3054 3055 3056 3057 3058 3059 3061 1343 
	3066 3067 3068 4668 4661 4644 4876 4877 4878 4879 4880 4881 4882 4883 4884 4885 
	4886 4887 4888 4889 4890 4891 4892 4893 4894 4895 4902 4903 4904 4905 4906 4907 4908 4909 
	4910 4911 4912 4913 4914 4915 4916 4917 4918 4919 4920 4921 4922 4923 4924 4925 4926 4927 
	4928 4929 4930 4931 4938 4652 881 882 883 884 885 886 887 888 889 893 894 895 896 897 898 
	899 900 901 903 904 905 906 907 908 909 910 911 912 913 914 915 916 917 918 919 920 921 
	922 923 924 925 926 927 928 929 930 931 932 933 934 935 936 937 938 939 940 941 942 943 
	944 945 946 947 948 951 960 961 965 970 975 989 1443 1517 1689 1716 1919 2135 2143 2181
	2748 3069 3070 3071 3072 3074 3075 3076 3077 3078 3079 3080 3081 3082 3084 3085 3086 3087 
	3088 3092 3093 3094 3096 3097 3101 3102 3104 3107 3108 3109 3110 3111 3112 3115 3116 3412 3633
}

only_used_for_random = {
}

lakes = {
	1663 1664 1665 1319 4224 1662 1661 4940 1883 1884 1885 1889
}

force_coastal = {
}

definitions = "definition.csv"
provinces = "provinces.bmp"
positions = "positions.txt"
terrain = "terrain.bmp"
rivers = "rivers.bmp"
terrain_definition = "terrain.txt"
heightmap = "heightmap.bmp"
tree_definition = "trees.bmp"
continent = "continent.txt"
adjacencies = "adjacencies.csv"
climate = "climate.txt"
region = "region.txt"
superregion = "superregion.txt"
area = "area.txt"
provincegroup = "provincegroup.txt"
ambient_object = "ambient_object.txt"
seasons = "seasons.txt"
trade_winds = "trade_winds.txt"
canal_definition = { #this sets the coordinates for where the panama_canal_river map file is inserted (starting from its bottom left corner)
	name = "panama_canal"
	x = 1490
	y = 948
}
canal_definition = {
	name = "suez_canal"
	x = 3275
	y = 1118
}
canal_definition = {
	name = "kiel_canal"
	x = 2937
	y = 1597
}

# Define which indices in trees.bmp palette which should count as trees for automatic terrain assignment
tree = { 3 4 7 10 }
