width = 5632
height = 2304

max_provinces = 4942
sea_starts = { 
	1567 1564 1582 1583 1578 1580 1565 1574 1571 1568 1581 1561 1289 1570 1577 1565 1304 1290
	1976 1888 1327 1263 4941 3525 1696 1695 1697 1694 1665 1664 1663 1741 1740 1683 4135 1291
	1739 1738 1737 1737 1736 1735 1734 1733 1732 1731 1730 1729 1728 1727 1726 1725 1724 1723
	1722 1721 1720 1719 1718 1717 1716 1715 1714 1713 1712 1711 1710 1709 1708 1707 1706 1705
	1703 1704 1690 1691 1692 1693 1697 1698 1699 1700 1701 1702 1687 1689 1688 1687 1686 1685
	1684 1682 1681 1680 1679 1677 1678 1563 1676 4357 1500 1501 1292 1293 4000 4347 4346 1325
	1250 1251 1252 1253 1254 1255 1256 1257 1258 1259 1260 1261 1262 1263 1264 1265 1266 1267
	1268 1269 1270 1271 1272 1274 1275 1276 1277 1278 1279 1280 1281 1282 1283 1284 1285 1647
	1286 1287 1288 1290 1291 1292 1293 1294 1295 1296 1297 1298 1298 1299 1300 1301 1302 1622
	1303 1304 1305 1307 1308 1309 1310 1311 1312 1313 1636 1618 1615 1586 1530 1459 1446
	1423 1336 1326 1616 1531 1532 1533 1534 1535 1536 1537 1538 1539 1540 1541 1542 1543 1544
	1545 1546 1547 1548 1549 1550 1551 1552 1553 1554 1555 1556 1557 1558 1559 1560 1562 1566
	1569 1572 1573 1575 1576 1579 1584 1585 1587 1588 1589 1590 1591 1592 1593 1594 1595 1596
	1597 1598 1599 1600 1601 1602 1603 1604 1605 1606 1607 1608 1609 1610 1611 1612 1613 1614
	1617 1619 1620 1621 1623 1624 1625 1626 1627 1628 1629 1630 1631 1632 1633 1634 1635 1637
	1638 1639 1640 1641 1642 1643 1644 1645 1646 1648 1649 1650 1651 1652 1653 1654 1655 1656
	1657 1658 1659 1660 1666 1667 1668 1669 1670 1671 1672 1673 1674 1675 1684 1696 1314 1315
	1316 1317 1320 1321 1322 1323 1324 1325 1328 1329 1330 1331 1332 1333 1334 1335 1337 1338
	1339 1340 1341 1342 1344 1345
}

only_used_for_random = {
}

lakes = {
	1663 1664 1665 1319 4224 1662 1661 4940 1883 1884 1885 1889
}

force_coastal = {
}

definitions = "definition.csv"
provinces = "provinces.bmp"
positions = "positions.txt"
terrain = "terrain.bmp"
rivers = "rivers.bmp"
terrain_definition = "terrain.txt"
heightmap = "heightmap.bmp"
tree_definition = "trees.bmp"
continent = "continent.txt"
adjacencies = "adjacencies.csv"
climate = "climate.txt"
region = "region.txt"
superregion = "superregion.txt"
area = "area.txt"
provincegroup = "provincegroup.txt"
ambient_object = "ambient_object.txt"
seasons = "seasons.txt"
trade_winds = "trade_winds.txt"
canal_definition = { #this sets the coordinates for where the panama_canal_river map file is inserted (starting from its bottom left corner)
	name = "panama_canal"
	x = 1490
	y = 948
}
canal_definition = {
	name = "suez_canal"
	x = 3275
	y = 1118
}
canal_definition = {
	name = "kiel_canal"
	x = 2937
	y = 1597
}

# Define which indices in trees.bmp palette which should count as trees for automatic terrain assignment
tree = { 3 4 7 10 }
